Алжир	Алжир
Ангола	Луанда
Бенин	Порто-Ново
Ботсвана	Габороне
Буркина-Фасо	Уагадугу
Бурунди	Гитега
Габон	Либревиль
Гамбия	Банжул
Гана	Аккра
Гвинея	Конакри
Гвинея-Бисау	Бисау
Джибути	Джибути
Египет	Каир
Замбия	Лусака
Зимбабве	Хараре
Кабо-Верде	Прая
Камерун	Яунде
Кения	Найроби
Коморские Острова	Морони
Демократическая Республика Конго	Киншаса
Республика Конго	Браззавиль
Кот-д’Ивуар	Ямусукро
Лесото	Масеру
Либерия	Монровия
Ливия	Триполи
Маврикий	Порт-Луи
Мавритания	Нуакшот
Мадагаскар	Антананариву
Малави	Лилонгве
Мали	Бамако
Марокко	Рабат
Мозамбик	Мапуту
Намибия	Виндхук
Нигер	Ниамей
Нигерия	Абуджа
Руанда	Кигали
Сан-Томе и Принсипи	Сан-Томе
Сахарская Арабская Демократическая Республика	Эль-Аюн
Сейшельские острова	Виктория
Сенегал	Дакар
Сомали	Могадишо
Сомалиленд	Харгейса
Судан	Хартум
Сьерра-Леоне	Фритаун
Танзания	Дар-эс-Салам
Того	Ломе
Тунис	Тунис
Уганда	Кампала
ЦАР	Банги
Чад	Нджамена
Экваториальная Гвинея	Малабо
Эритрея	Асмэра
Эсватини	Мбабане
Эфиопия	Аддис-Абеба
Южно-Африканская Республика	Претория
Южный Судан	Джуба